3,127,127,127,127,127,127,127,127,127,127,127,127,127,127,127,127,127,127,127,127,127,127,127,127,127,127,127,127,127,127,127
6,127,127,127,127,127,127,127,127,127,127,127,127,127,127,127,127,127,127,127,127,127,127,127,127,127,127,127,127,127,127,127
6,127,127,127,127,127,127,127,127,127,127,127,127,127,127,127,127,127,127,127,127,127,127,127,127,127,127,127,127,127,127,127
6,127,127,127,127,127,127,127,127,127,127,127,127,127,127,127,127,127,127,127,127,127,127,127,127,127,127,127,127,127,127,127
6,127,127,127,127,127,127,127,127,127,127,127,127,127,127,127,127,127,127,127,127,127,127,127,127,127,127,127,127,127,127,127
6,127,127,127,1,2,2,2,2,2,2,2,2,2,127,127,127,127,127,127,127,127,127,127,127,127,127,127,127,127,127,127
6,127,127,127,4,5,5,5,5,5,5,5,5,5,1,2,2,2,2,2,3,127,127,127,127,127,127,127,127,127,127,127
6,127,127,127,7,8,8,8,8,8,8,8,8,9,5,5,5,5,5,5,6,127,127,127,127,127,127,127,127,127,127,127
6,127,127,127,127,127,127,127,127,127,127,127,127,127,8,8,8,8,8,8,9,127,127,127,127,127,127,127,127,127,127,127
6,127,127,127,127,127,127,127,127,127,127,127,127,127,127,127,127,127,127,127,127,127,127,127,127,127,127,127,127,127,127,127
6,127,127,127,127,127,127,127,127,127,127,127,127,127,127,127,127,127,127,127,127,127,127,127,127,127,127,127,127,127,127,127
6,127,127,127,127,127,127,127,127,127,127,127,127,127,127,127,127,127,127,127,127,127,127,127,127,127,127,127,127,127,127,127
6,127,127,127,127,127,127,127,127,127,127,127,127,127,127,127,127,127,127,127,127,127,127,127,127,127,127,127,127,127,127,127
6,127,127,127,127,127,127,127,127,127,127,127,127,127,127,127,127,127,127,127,127,127,127,127,127,127,127,127,127,127,127,127
6,127,127,127,127,127,127,127,127,127,127,127,127,127,127,127,127,127,127,127,127,127,127,127,127,127,127,127,127,127,127,127
2,2,2,2,2,2,2,2,2,2,2,2,2,2,2,3,127,127,127,127,127,1,2,2,2,2,2,2,2,2,2,2
5,5,5,5,5,5,5,5,5,5,5,5,5,5,5,6,127,127,127,127,127,4,5,5,5,5,5,5,5,5,5,5
5,5,5,5,5,5,5,5,5,5,5,5,5,5,5,6,127,127,127,127,127,4,5,5,5,5,5,5,5,5,5,5
