4,5,5,5,5,5,5,5,5,5,5,5,5,5,5,5,5,5,5,6
7,8,8,8,8,8,8,8,8,8,8,8,8,8,8,8,8,8,8,9
7,8,8,8,8,8,8,8,8,8,8,8,8,8,8,8,8,8,8,9
7,8,8,8,8,8,8,8,8,8,8,8,8,8,8,8,8,8,8,9
7,8,8,8,8,8,8,8,8,8,8,8,8,8,8,8,8,8,8,9
7,8,8,8,8,8,8,8,8,8,8,8,8,8,8,8,8,8,8,9
7,8,8,8,8,8,8,8,8,8,8,8,8,8,8,8,8,8,8,9
7,8,8,8,8,8,8,8,8,8,8,8,8,8,8,8,8,8,8,9
7,8,8,8,8,8,8,8,8,8,8,8,8,8,8,8,8,8,8,9
7,8,8,8,8,8,8,8,8,8,8,8,8,8,8,8,8,8,8,9
7,8,8,8,8,8,8,8,8,8,8,8,8,8,8,8,8,8,8,9
7,8,8,8,8,8,8,8,8,8,8,8,8,8,8,8,8,8,8,9
7,8,8,8,8,8,8,8,8,8,8,8,8,8,8,8,8,8,8,9
7,8,8,8,8,8,8,8,8,8,8,8,8,8,8,8,8,8,8,9
10,11,11,11,11,11,11,11,11,11,11,11,11,11,11,11,11,11,11,12
